111111111
100000E01
1000C0001
111111111
