111111111
10P000E01
10Z0C0001
111111111
