111111111
100000E01
10P0E0C01
111111111
