1111111111
100000E01
10P000C00001
111111111111
