1111111111
000000E000
00P000C000
1111111111
