111111111
100000E01
10P000001
111111111
