11111111111
1P0000C0011
10C000001E1
11111111111