111111111111111111
1E000000C000000001
100111111110011101
10C00000C000000001
111111111111111001
111000000C00000001
111111111111110001
1000C00C0000000001
100001111111111101
1000000000000000P1
111111111111111111
