111111111111111
1PEC0100C0000C1
111111111111111
