111111111111111
1CEC0000C010PC1
111111111111111
