111111111111111
100C0000C0000C1
100C00C0000P001
10E1C1111110001
101C100C0000001
100100000C000C1
100000000000001
111111111111111
