1111111111
100000E001
10P000C001
1111111111
